            .   .
            | X |
.___.___.___.   .___.
|   | T        T    |
.   .   .   .___.   .
|     T |       | M |
.   .___.   .   .   .
|           |       |
.   .___.___.   .   .
|           |   |   |
.   .   .   .___.   .
|                   |
.___.___.___.___.___.