            .   .
            | X |
.___.___.___.   .___.
|   | T             |
.   .   .   .___.   .
|       |       | M |
.   .___.   .   .   .
|           |       |
.   .___.___.   . M .
|           |   |   |
.   .   .   .___. M .
|                   |
.___.___.___.___.___.